//////////////////////!/////////////////
//////////////////////./////////////////
//////////////////////./////////////////
//////////////////////./////////////////
///////////////////..../////////////////
///////////////////..///////////////////
///////////////////..///////////////////
///////////////////..///////////////////
///////////////////...//////////////////
/////////////////////.//////////////////
/////////////////////.//////////////////
/////////////////////.//////////////////
/////////////////////.//////////////////
/////////////////////.//////////////////
/////////////////////.//////////////////
///////////////////.....////////////////
///////////////////..././///////////////
///////////////////..././///////////////
///////////////////..././///////////////
/////////.......///////.////////////////
/////////./////.///////.////////////////
/////////./////.///////.////////////////
/////////./////.........////////////////
/////////.//////////////////////////////
/////////.//////////////////////////////
//////....//////////////////////////////
//////./////////////////////////////////
//////....//////////////////////////////
//////........//////////////////////////
//////...@....//////////////////////////
//////........//////////////////////////
//////........//////////////////////////
